1111111111111111111111
10000C0001111011000001
1001001000000001101111
10010011111110110000C1
1P010000011CCC0E000001
1111111111111111111111